o o o o o o o o o o o o o o o o o o o o o o o o o o o o
o o o o o o o o o o o o o o o o o o o o o o o o o o o o
o o o o o o o o o o o o o o o o o o o o o o o o o o o o
x x x x x x x x x x x x x x x x x x x x x x x x x x x x
x p p p p p p p p p p x o x p p p p p p p p p p p p a x
x p x x x p x x x x p x x x p x x x p x x x p x x x p x
x p x x x p x x x p p p p p p p p p p x x x p x x x p x
x p x x x p x x x p x x x x p x x x p p p p p p p p p x
x p p p p p p p p p x o o x p x o x p x x x p x x x p x
x p x x x p x x x p x o o x p x o x p x o x p p p p p x
x p x x x p x x x p x o o x p x o x p x o x p x x x x x
x p p p p p x x x p x o o x p x o x p x o x p x o o o x
x p x x x p x p p p x o o x p x o x p x o x p x o o o x
x p p p p p p p x p x o o x p x o x p x o x p x o o o x
x x p x x p x p x p x o o x p x o x p x x x p x x x x x
x x p x x p x p x p x x x x p x x x p p p p c p p p p x
x x p x x p x p x p p p p p p r p p p x x x p x x x x x
x x p x x p x p x p p x x x x x x p x x o x p x o o o x
x x p x x p p p p p p x o o o o x p x o o x p x o o o x
x x p x x p x p x x x x x x x x x p x x x x p x o o o x
x x p x x p x p x p p p p p p p p p p p p p p x x x x x
x x p x x p x p x p x x x x x x p x x x p p p p p p p x
x x p x x p x p x p x o o o o x p x o x p x x x x x p x
x x s x x p x p x p x o o o o x p x o x p x x p p p p x
x p p p p p p p x p x x o o o x p x o x p x x p x x x x
x p x x x x x p p p p x x x x x p x x x p p p p p p p x
x p x x x x x p x x p p p p p p p p p p p x p x x x p x
x p p p p x x p x x p x x x x x x x p x p x p x o x p x
x x x x p x x p x x p x x x x x x x p x p x p x o x p x
x x x x p x x p x x p p p x x p p p p x p p p x o x p x
x p p p p p p p x x x x p x x p x x x x x x p x o x p x
x p x x x x x x x x x x p x x p x x x x x x p x x x p x
x p p p p p p p p p p p p p p p p p p p i p p p p p p x
x x x x x x x x x x x x x x x x x x x x x x x x x x x x
o o o o o o o o o o o o o o o o o o o o o o o o o o o o
o o o o o o o o o o o o o o o o o o o o o o o o o o o o